###############################################################################
###############################################################################
###                                   ###                                   ###
###  ###############  ##############  ###  ###############  ##############  ###
###  ###############  ##############  ###  ###############  ##############  ###
###  ###############  ##############  ###  ###############  ##############  ###
###                                                                         ###
###  ###############  ###  ##########################  ###  ##############  ###
###  ###############  ###  ##########################  ###  ##############  ###
###                   ###             ###              ###                  ###
###  ###############  ##############  ###  ###############  ##############  ###
###              ###  ##############  ###  ###############  ###             ###
###  ##########  ###  ###                              ###  ###  #########  ###
###  ##########  ###  ###  ###########   ############  ###  ###  #########  ###
###              ###  ###  ##                      ##  ###  ###             ###
###  ###############  ###  ##                      ##  ###  ##############  ###
###                        ##                      ##                       ###
####################  ###  ##########################  ###  ###################
####################  ###                              ###  ###################
####################  ###  ##########################  ###  ###################
####################  ###  ##########################  ###  ###################
###                                   ###                                   ###
###  ###############  ##############  ###  ###############  ##############  ###
###  ###############  ##############  ###  ###############  ##############  ###
###             ####                                        ####            ###
##############  ####  ####  #######################  #####  ####  #############
##############  ####  ####  #######################  #####  ####  #############
##############  ####  ####  #######################  #####  ####  #############
###                   ####            ###            #####                  ###
###  ###############################  ###  ###############################  ###
###  ###############################  ###  ###############################  ###
###  ###############################  ###  ###############################  ###
###                                                                         ###
###############################################################################
###############################################################################